20 20 20 20 20 20 20 20 20 20 20 20 20 20 20 20 20 20 20 20 20 20 20 20 20 20 20 20 20 20 20 20 20 20 20 20 20 20 20 20 20 20 20 20 20 20 20 20 20 20
20 21 21 20 23 23 23 21 21 21 21 21 21 21 21 21 21 21 21 21 21 21 21 21 21 21 21 21 21 21 21 21 21 21 21 21 21 21 21 21 21 21 21 21 21 21 21 21 21 20
20 21 21 21 21 23 21 21 21 21 21 21 21 21 28 29 29 29 29 29 29 29 29 29 29 29 29 29 29 29 29 29 29 29 29 29 29 29 29 29 29 29 29 29 29 29 29 29 29 29
20 21 21 20 21 23 23 21 21 21 21 21 21 21 15 22 22 22 22 22 22 22 22 22 22 22 22 22 22 22 22 22 22 22 22 22 22 22 22 22 22 22 22 22 22 22 22 22 22 22
20 20 20 20 21 23 23 21 21 21 21 21 21 21 15 22 22 22 22 22 22 22 22 22 22 22 22 22 22 22 22 22 22 22 22 22 22 22 22 22 22 22 22 22 22 22 22 22 22 22
20 23 21 23 21 23 23 21 21 21 21 21 21 21 14 13 13 13 13 13 13 16 17 13 13 13 13 13 13 13 13 13 13 13 13 13 13 13 13 16 22 17 13 13 13 13 13 16 22 17
20 23 21 21 21 23 21 21 21 21 21 21 21 21 21 21 21 21 21 21 21 15 11 21 21 21 21 21 21 21 21 21 21 21 21 21 21 21 21 15 22 11 23 21 21 21 21 15 22 11
20 23 21 23 21 23 23 23 21 21 21 21 21 21 21 21 21 21 21 21 21 15 11 21 21 21 21 21 21 21 21 21 21 21 21 21 21 21 21 15 22 11 23 21 21 21 21 15 22 11
20 23 21 23 23 21 23 23 21 21 21 21 21 21 21 21 21 21 21 21 21 15 11 21 21 21 21 21 21 21 21 21 21 21 21 21 21 21 21 15 22 11 23 21 21 21 21 15 22 11
20 23 21 23 23 23 23 23 21 21 21 21 21 21 21 21 21 21 21 21 21 15 11 21 21 21 21 21 21 21 21 21 21 21 21 21 21 21 21 15 22 11 23 21 21 21 21 15 22 11
20 23 21 23 21 21 21 21 21 21 21 21 21 21 21 21 21 21 21 21 21 15 11 21 21 21 21 21 21 21 21 21 21 21 21 21 21 21 21 15 22 11 23 21 21 21 21 14 13 12
20 23 21 23 21 21 21 21 21 21 21 21 21 21 21 21 21 21 21 21 21 15 11 21 21 21 21 21 21 21 21 21 21 21 21 21 21 21 21 15 22 11 23 21 21 21 21 21 21 20
20 23 21 23 23 23 23 23 23 23 23 23 23 21 21 21 21 21 21 21 21 15 11 21 21 21 21 21 21 21 21 21 21 21 21 21 21 21 21 15 22 11 23 21 21 21 21 21 21 20
20 23 21 21 21 21 21 21 21 21 21 21 21 21 21 21 21 21 21 21 21 14 12 21 23 21 21 21 21 21 21 21 21 21 21 21 21 21 21 15 22 11 23 21 21 21 21 21 21 20
20 23 21 25 25 25 25 25 25 25 25 25 25 25 25 25 25 21 21 21 21 21 21 21 21 21 21 21 21 21 21 21 21 21 21 21 21 21 21 15 22 11 23 21 21 21 21 21 21 20
20 23 21 25 25 25 25 25 25 25 25 25 25 21 21 21 25 21 21 21 21 21 21 23 21 21 21 21 21 21 21 21 21 21 21 21 21 21 21 15 22 11 23 21 21 21 21 21 21 20
20 23 21 25 21 21 21 21 21 21 21 21 21 21 21 21 25 21 21 21 21 21 21 21 21 21 21 21 21 21 21 21 21 21 21 21 21 21 21 15 22 11 23 21 21 21 21 21 21 20
20 23 21 25 25 25 21 25 25 25 25 25 25 21 25 25 25 21 21 21 21 21 21 21 21 21 23 21 21 21 21 21 21 21 21 21 21 21 21 15 22 11 23 21 21 21 21 21 21 20
20 23 21 25 25 25 21 25 25 25 25 25 25 21 25 21 21 21 21 21 21 21 21 21 21 21 21 21 21 21 21 21 21 21 21 21 21 21 21 15 22 11 23 21 21 21 21 21 21 20
20 23 21 25 25 21 21 21 25 25 25 25 25 21 25 21 21 21 21 21 21 21 21 21 23 21 21 21 21 21 21 21 21 21 21 21 21 21 21 15 22 11 23 21 21 21 21 21 21 20
20 23 21 25 25 21 21 21 25 25 25 25 25 21 21 21 21 21 28 29 10 23 23 23 21 21 25 21 21 21 21 21 21 21 21 21 21 21 21 15 22 11 23 21 21 21 21 21 21 20
20 23 21 25 25 25 21 25 25 25 25 25 25 21 21 21 21 21 15 22 11 23 23 23 21 21 21 21 21 28 29 29 29 29 29 29 29 29 29 18 22 11 23 21 21 21 21 21 21 20
20 23 21 21 25 25 21 25 25 25 25 25 25 21 21 21 21 21 14 13 12 23 23 23 21 21 21 21 21 14 13 13 13 13 13 13 13 13 19 22 22 11 23 21 21 21 21 21 21 20
20 23 21 25 25 25 21 25 25 25 25 25 21 21 21 21 21 21 21 21 21 21 21 23 21 21 21 21 21 21 21 21 21 21 21 21 21 21 15 22 22 11 23 21 21 21 21 21 21 20
20 23 25 25 25 25 21 25 25 25 25 25 21 21 21 21 21 21 21 21 21 23 23 23 21 21 21 21 21 21 21 21 21 21 21 21 21 21 14 13 13 12 21 21 21 21 21 21 21 20
20 23 25 25 25 25 21 25 25 25 25 25 21 21 21 21 21 21 21 21 21 21 21 21 21 21 21 21 21 21 21 21 21 21 21 21 21 21 21 21 21 21 21 21 21 21 21 21 20 20
20 23 21 25 21 25 21 25 25 25 25 25 25 21 21 21 21 21 21 21 21 21 21 21 21 21 21 21 21 21 21 21 21 21 21 21 21 21 21 21 21 21 21 21 21 21 21 21 20 20
20 21 21 25 21 21 21 21 21 21 21 21 21 21 21 21 21 21 21 21 21 21 21 21 21 21 21 21 21 21 21 21 21 21 21 21 21 21 21 21 21 21 21 21 21 21 21 21 21 20
20 21 21 21 21 21 21 21 21 21 21 21 21 21 21 21 21 21 21 21 21 21 21 21 21 21 21 21 21 21 21 21 21 21 21 21 21 21 21 21 21 21 21 21 21 21 21 21 21 20
20 21 21 21 21 21 21 21 21 21 21 21 21 21 21 21 21 21 21 21 21 21 21 21 21 21 21 21 21 21 21 21 21 21 21 21 21 21 21 21 21 21 21 21 21 21 21 21 21 20
20 21 21 21 21 21 21 21 21 21 21 21 21 21 21 21 21 21 21 21 21 21 21 21 21 21 21 21 21 21 21 21 21 21 21 21 21 21 21 21 21 21 21 21 21 21 21 21 21 20
20 21 21 21 21 21 21 21 21 21 21 21 21 21 21 21 21 21 21 21 21 21 21 21 21 21 21 21 21 21 21 21 21 21 21 21 21 21 21 21 21 21 21 21 21 21 21 21 21 20
20 21 21 21 21 21 21 21 21 21 21 21 21 21 21 21 21 21 21 21 21 21 21 21 21 21 21 21 21 21 21 21 21 21 21 21 21 21 21 21 21 21 21 21 21 21 21 21 21 20
20 21 21 21 21 21 21 21 21 21 21 21 21 21 21 21 21 21 21 21 21 21 21 21 21 21 21 21 21 21 21 21 21 21 21 21 21 21 21 21 21 21 21 21 21 21 21 21 21 20
20 21 21 21 21 21 21 21 21 21 21 21 21 21 21 21 21 21 21 21 21 21 21 21 21 21 21 21 21 21 21 21 21 21 21 21 21 21 21 21 21 21 21 21 21 21 21 21 21 20
20 21 21 21 21 21 21 21 21 21 21 21 21 21 21 21 21 21 21 21 21 21 21 21 21 21 21 21 21 21 21 21 21 21 21 21 21 21 21 21 21 21 21 21 21 21 21 21 21 20
20 21 21 21 21 21 21 21 21 21 21 21 21 21 21 21 21 21 21 21 21 21 21 21 21 21 21 21 21 21 21 21 21 21 21 21 21 21 21 21 21 21 21 21 21 21 21 21 21 20
20 21 21 21 21 21 21 21 21 21 21 21 21 21 21 21 21 21 21 21 21 21 21 21 21 21 21 21 21 21 21 21 21 21 21 21 21 21 21 21 21 21 21 21 21 21 21 21 21 20
20 21 21 21 21 21 21 21 21 21 21 21 21 21 21 21 21 21 21 21 21 21 21 21 21 21 21 21 21 21 21 21 21 21 21 21 21 21 21 21 21 21 21 21 21 21 21 21 21 20
20 21 21 21 21 21 21 21 21 21 21 21 21 21 21 21 21 21 21 21 21 21 21 21 21 21 21 21 21 21 21 21 21 21 21 21 21 21 21 21 21 21 21 21 21 21 21 21 21 20
20 21 21 21 21 21 21 21 21 21 21 21 21 21 21 21 21 21 21 21 21 21 21 21 21 21 21 21 21 21 21 21 21 21 21 21 21 21 21 21 21 21 21 21 21 21 21 21 21 20
20 21 21 21 21 21 21 21 21 21 21 21 21 21 21 21 21 21 21 21 21 21 21 21 21 21 21 21 21 21 21 21 21 21 21 21 21 21 21 21 21 21 21 21 21 21 21 21 21 20
20 21 21 21 21 21 21 21 21 21 21 21 21 21 21 21 21 21 21 21 21 21 21 21 21 21 21 21 21 21 21 21 21 21 21 21 21 21 21 21 21 21 21 21 21 21 21 21 21 20
20 21 21 21 21 21 21 21 21 21 21 21 21 21 21 21 21 21 21 21 21 21 21 21 21 21 21 21 21 21 21 21 21 21 21 21 21 21 21 21 21 21 21 21 21 21 21 21 21 20
20 21 21 21 21 21 21 21 21 21 21 21 21 21 21 21 21 21 21 21 21 21 21 21 21 21 21 21 21 21 21 21 21 21 21 21 21 21 21 21 21 21 21 21 21 21 21 21 21 20
20 21 21 21 21 21 21 21 21 21 21 21 21 21 21 21 21 21 21 21 21 21 21 21 21 21 21 21 21 21 21 21 21 21 21 21 21 21 21 21 21 21 21 21 21 21 21 21 21 20
20 21 21 21 21 21 21 21 21 21 21 21 21 21 21 21 21 21 21 21 21 21 21 21 21 21 21 21 21 21 21 21 21 21 21 21 21 21 21 21 21 21 21 21 21 21 21 21 21 20
20 21 21 21 21 21 21 21 21 21 21 21 21 21 21 21 21 21 21 21 21 21 21 21 21 21 21 21 21 21 21 21 21 21 21 21 21 21 21 21 21 21 21 21 21 21 21 21 21 20
20 21 21 21 21 21 21 21 21 21 21 21 21 21 21 21 21 21 21 21 21 21 21 21 21 21 21 21 21 21 21 21 21 21 21 21 21 21 21 21 21 21 21 21 21 21 21 21 21 20
20 20 20 20 20 20 20 20 20 20 20 20 20 20 20 20 20 20 20 20 20 20 20 20 20 20 20 20 20 20 20 20 20 20 20 20 20 20 20 20 20 20 20 20 20 20 20 20 20 20



